Option                 	Type   	Value           	Range
redirectOut            	boolean	false           
init                   	boolean	true            
shutdown               	boolean	true            
setup                  	boolean	true            
cleanup                	boolean	true            
deleteEmptyLog         	boolean	true            
removeLogOnSuccess     	boolean	false           
dotifyCoverage         	boolean	false           
dotDir                 	String	.               
stopOnFailure          	boolean	false           
precondAsFailure       	boolean	false           
printStackTrace        	boolean	true            
showChoices            	boolean	true            
classpath              	String	.               
logPath                	String	log             
offline                	String	no              	{no, standalone, junit}
offlineDest            	String	                
rethrowExceptions      	boolean	false           	[1]
logLevel               	int	info            	{none, error, warning, info, fine, debug, all}
randomSeed             	long	1               	1..inf
abortProbability       	double	0.0             	0.0..1.0
maybeProbability       	double	0.5             	0.0..1.0
nRuns                  	int	50              	1..inf
mode                   	String	exec            	{dot, exec}
loopLimit              	int	0               	0..inf
autoLabels             	boolean	true            
[1] requires offline to be set to value other than no if option is set.
